161111111111111111111111
100101000100010000000001
100101010101010111111101
100001010101000100000001
100101010101001100111011
100100010101001000001001
110111111111111011001001
100000000000000001001001
100111111111110001001101
101100000000011111101001
100101111101000000101011
100101000101000000101001
100101010101011111101001
100101010101010000001101
110100010101010101111001
100100010101010000000001
100111110101011100100001
100000000101000111110111
101111111101010000010101
100000000001010010010109
100111111111111111000101
100100001001000101010001
110000100000010001010001
111111111111111111111111