111161111111111111111111
100000100000000100000011
100000101111110111001101
111011100000010100011001
100000100110010100110001
101111100010010100100101
101000100010010001100101
101110100011000001000001
100010111010000001010001
100000000011111001011111
101011110010000001000001
101000010011110001001111
101011010010000001000001
101011010011100000000111
101000010010001110000001
101111110010001010100011
100000000010101010100001
100000000010100010100101
111111000010101010100101
101001110111111010000101
101000000000000010000001
101111111111111110111011
100000000000000000100001
111111111111111911111111