111611111111111111111111
100000000000000000000011
111101111000111101111111
100010000100010010100001
101011100100010110110111
101000000000010000100001
101111111111110000001111
100000000000000000100001
111111001110111111111001
100001001000000000001101
101101001011100111111001
100100001000100100001011
100111111111101110111001
100000100000001010100101
101100100111111010100101
101001100100010010110111
101111010101010110000001
100001000101010011101001
111111101111011010100101
100000101000011110100011
101110000011110001001009
101010010010000101101001
100010011000110100001101
111111111111111111111111