111111111111111111111111
110010100110000011000111
110000110011000110001101
111100001001101100111001
600101000101001001100011
100001100010101011010101
100100111010000000101001
110100011000101101010001
111111001100011000110111
101010000100110010000001
100000101101101010101011
100101111100101110011111
100101010110110101010101
101000001111111001000001
111001011000001001011101
100010110001101100010101
101000100111000110010101
101001100100010011110001
111100001011011000100101
100010010011010110001101
100110100101010100101101
101100001001011111100111
101010010000010000000011
111111111191111111111111
