111111111111111111111111
100000000000000000000101
101111111111111111110101
100000000000000000000101
101011111111111111111101
101010000001000000000109
101010111111110111110101
101010110000000000110101
101010001101111111010001
101010101000000001010101
101010101011110101010111
101010101010100101010101
101010101010110100010101
101010101110010111010101
101010101000000101011101
101010101011111101110101
101000101000000001010101
101010101110111111010001
101010100000000000110101
101010111111111111110101
101010000000000000000101
601011110111111110111101
101000000000100000000001
111111111111111111111111