116111111111111111111111
100000000000000010000001
101110000100010010011101
100011011111111000010101
111010000000001111110101
100010010010000000000101
101111010011100111011101
100000010010001100010001
100111111011000000011011
101100010000011010110001
100101000011100010011101
110111111110001010110001
100000000000001010010111
111111111110111110110001
110000001000100000000001
100011100010101101101011
101111111111101000100001
101000001000001000000001
101101110001111110111111
101000010100000010000001
101111010111111011111101
101000011100010000100001
100000010001000101011001
111111119111111111111111