111111111111111111111111
101001000100000000000101
101011010111111111110101
101000010100010000010001
101111110001010011000101
100001010111011000010101
111001000100001011110101
101011110100000000000001
100001000101111110110111
101111010000000000000101
101000000101110111000001
101111011100100000011101
100101010000000000000001
100000010111101110111011
101010010010000100000001
111110110110100101111101
100000100010110100010001
111101001010100100010101
100000001010100111110101
100111111110110000100101
100000000000100101001001
101111111001101111101111
600000001000010000100009
111111111111111111111111